1111111
1000001
100C001
10000P1
1111111