1111111
1E00001
100C001
1000001
1111111