1111111
1E00001
100C001
10000P0
1111111