1111111
1E11111
111C111
11111P1
1111111