111111111
100000001
1E000C001
10001C001
10000C001
10000C001
10000P001
111111111