111111111
100010001
1E000C001
10001C001
10P01C001
111011111
10C010001
111111111