1111111
1E00001
100C001
10000P
1111111