1111111
1E00001
100C111
10001P1
1111111