111111111
1CCC1CC01
1E000C0P1
10001C001
10001C001
111011111
10C010001
111111111